#PrimerName	PrimerSequence (IUPAC degeneracies OK)
1391F	GTACACACCGCCCGTC
926R	CCGYCAATTYMTTTRAGTTT
806R	GGACTACHVGGGTWTCTAAT
515F	GTGCCAGCMGCCGCGGTAA
515Fmod	GTGYCAGCMGCCGCGGTAA
5.8S_Fun	AACTTTYRRCAAYGGATCWCT
AML2	GAACCCAAACACTTTGGTTTCC
EukBR	TGATCCTTCTGCAGGTTCACCTAC
ITS1F	CTTGGTCATTTAGAGGAAGTAA
ITS2	GCTGCGTTCTTCATCGATGC
ITS3	GCATCGATGAAGAACGCAGC
ITS4_Fun	AGCCTCCGCTTATTGATATGCTTAART
ITS4	TCCTCCGCTTATTGATATGC
ITS5	GGAAGTAAAAGTCGTAACAAGG
ITS7o	GTGAATCATCRAATYTTTG
LR0R	ACCCGCTGAACTTAAGC
LR3	CCGTGTTTCAAGACGGG
P5	AATGATACGGCGACCACCGAGA
P7	CAAGCAGAAGACGGCATACGAGAT
WANDA	CAGCCGCGGTAATTCCAGCT	
